electron => Hydrogen,Flourine|Nitrogen,Aluminum|Oxygen,Magnesium
Aluminum => aluminum|Thorium,Flourine|Thorium,RadonFlourineArgon
Boron => boron|Boron,Calcium|Titanium,Boron|Titanium,RadonFlourineArgon
Calcium => calcium|Calcium,Calcium|Phosphorus,Boron|Phosphorus,RadonFlourineArgon|Silicon,RadonFlourineYttriumFlourineArgon|Silicon,RadonMagnesiumArgon|Silicon,Thorium
Flourine => flourine|Calcium,Flourine|Phosphorus,Magnesium|Silicon,Aluminum
Hydrogen => hydrogen|Carbon,RadonAluminumArgon|CarbonRadonFlourineYttrium,FlourineYttriumFlourineArgon|CarbonRadonFlourineYttrium,MagnesiumArgon|CarbonRadonMagensium,YttriumFlourineArgon|Hydrogen,Calcium|Nitrogen,RadonFlourineYttriumFlourineArgon|Nitrogen,RadonMagnesiumArgon|Nitrogen,Thorium|Oxygen,Boron|Oxygen,RadonFlourineArgon
Magnesium => magnesium|Boron,Flourine|Titanium,Magnesium
Nitrogen => nitrogen|Carbon,RadonFlourineArgon|Hydrogen,Silicon
Oxygen => oxygen|Carbon,RadonFlourineYttriumFlourineArgon|Carbon,RadonMagnesiumArgon|Hydrogen,Phosphorus|Nitrogen,RadonFlourineArgon|Oxygen,Titanium
Phosphorus => phosphorus|Calcium,Phosphorus|Phosphorus,Titanium|Silicon,RadonFlourineArgon
Silicon => silicon|Calcium,Silicon
Thorium => thorium|Thorium,Calcium
Titanium => titanium|Boron,Phosphorus|Titanium,Titanium
CarbonRadonFlourineYttrium => Carbon,RadonFlourineYttrium
CarbonRadonMagensium => Carbon,RadonMagnesium
FlourineArgon => Flourine,Argon
FlourineYttriumFlourineArgon => Flourine,YttriumFlourineArgon
MagnesiumArgon => Magnesium,Argon
RadonAluminum => Radon,Aluminum
RadonAluminumArgon => RadonAluminum,Argon
RadonFlourine => Radon,Flourine
RadonFlourineArgon => RadonFlourine,Argon
RadonFlourineYttrium => RadonFlourine,Yttrium
RadonFlourineYttriumFlourineArgon => RadonFlourineYttrium,FlourineArgon
RadonMagnesium => Radon,Magnesium
RadonMagnesiumArgon => RadonMagnesium,Argon
YttriumFlourineArgon => Yttrium,FlourineArgon
Argon => argon
Carbon => carbon
Radon => radon
Yttrium => yttrium